XXXXXXXX
X      X
X     GX
X    XXX
XX     X
X    S X
XXXXXXXX